007大破天幕	电影
300英雄	体育
Beyond	生活
CCTV	音乐
FashionFun致尚	生活
G20杭州	新闻
GetItBeauty	时尚
HELLO	健康
Kiss	生活
LOVE	综艺
MAMA	少儿
RunningMan	综艺
TICO	少儿
X战警天启	电影
一个强盗都不留	电视剧
一周时尚	时尚
一声所爱大地飞歌	音乐
一日一字	科教
一站到底	综艺
一门三司令	电视剧
一马换三羊	电视剧
一鸣惊人	戏曲
七天爱上你	综艺
七妹	电视剧
万万没想到	综艺
万万看不懂	综艺
三妹	电视剧
上海迪士尼	生活
上阵父子兵	综艺
不可思议	电影
不请自来	电影
世界周刊	新闻
世界大力士	综艺
世界观察	新闻
世界青年说	综艺
丛林大反攻4吓傻了	电影
东北解放战争全纪录	电视剧
东南气象	生活
东方全纪录	纪实
东方卫视	综艺
东西南北	科教
中华好民歌	音乐
中华好诗词	科教
中华情	综艺
中国	综艺
中国24小时	新闻
中国之星	综艺
中国住房	纪实
中国好声音	综艺
中国好家庭	综艺
中国成语大会	科教
中国故事	纪实
中国教育报道	科教
中国文艺	综艺
中国梦	音乐
中国正在	综艺
中国设计	纪实
中国诗词大会	综艺
中国课堂	科教
中国谜语大会	生活
中国龙虎榜	体育
中央电视台	综艺
主角驾到	综艺
乐比悠悠	少儿
九九艳阳天	电影
九州大戏台	戏曲
书法课堂	科教
书画人生	科教
了不起	综艺
二胎时代	综艺
五年规划	纪实
五月的鲜花全国大中学	综艺
五洲四海山东人	纪实
五鼠闹东京	电视剧
亚洲潮流	生活
亚洲音乐	音乐
人文地理	科教
人文大家	纪实
人文深呼吸	纪实
人说山西好风光	综艺
人间春色	生活
人间真情	综艺
今晚80后脱口秀	综艺
今童王世界	少儿
休闲街区	体育
优秀作品	纪实
优秀儿童剧	少儿
伟大的贡献	纪实
传奇剧精彩	综艺
伶人王中王	综艺
体育报道	体育
你好历史君	综艺
你最想知道的科学	纪实
佳片有约	电影
侬最有腔调	综艺
保罗莫顿	旅游
信号	电视剧
借刀杀人	电影
光荣绽放	综艺
克拉之恋	电视剧
党风廉政	科教
全球财经	财经
六小龄童	电视剧
兰陵王	电视剧
养护宝典	汽车
养生堂	科教
养生汇	健康
军迷淘天	军事
冠军宝贝	少儿
冰路前行	纪实
冰雪奇缘	电影
决战背后的决战	纪实
出彩中国人	综艺
刑侦一号案	电视剧
创富	财经
初恋这件小事	电视剧
功夫熊猫	电影
北京国际	综艺
北京遇上西雅图	电影
午间气象	生活
卑鄙的我	电影
南京南京	电影
南太平洋	纪实
卡拉OK	电影
卧虎藏龙青冥宝剑	电影
厄尔尼诺	电影
厄瓜多尔	纪实
厨王争霸	综艺
变形金刚	少儿
变身小英雄	少儿
口述西藏	科教
古老的世界	纪实
史酷比与	电影
史酷比和	电影
名侦探柯南	电视剧
名家临碑帖	科教
向幸福出发	综艺
周末大放送	电视剧
周末特供	时尚
命悬一线	纪实
命运石之门	少儿
哈利波特	电影
哈姆太郎	少儿
唐人街探案	电影
唐宋八大家	纪实
唱儿歌学英语	少儿
喜剧人	综艺
喜羊羊	少儿
回声嘹亮	综艺
因为爱情	电影
国史演义	科教
图图的智慧王国	少儿
圣斗士星矢	少儿
地平线系列	纪实
地心引力	电影
城市之光	电影
大医生	健康
大手牵小手	少儿
大爱东方	综艺
大魔术师	综艺
天上掉下	少儿
天下收藏	科教
天下父母	综艺
天地长白	纪实
天天健康	健康
天天向上	综艺
天天快乐岛	少儿
天天把歌唱	综艺
天涯共此时	综艺
太子妃升职记	电视剧
太阳的后裔	电视剧
央视元宵	综艺
奇幻海洋	科教
奉化94天	纪实
奔跑吧兄弟	电影
女不强大天不容	电视剧
女医明妃传	电视剧
女驸马	电影
奶爸的爱情生活	电视剧
好先生	电视剧
好好学习吧	生活
妈妈咪呀	综艺
娱乐乐翻天	综艺
孔府档案	纪实
孙子兵法	科教
宇宙的奇迹	纪实
安徽卫视	综艺
定制好身材	综艺
宝贝乐园	少儿
家庭幽默	综艺
寰宇视野	科教
小学数学	科教
小海龟大	电影
小狐狸发明记	少儿
小猪佩奇	少儿
小飞狗环球旅行	少儿
小黄人大眼萌	电影
岁月丹青	纪实
巴啦啦小魔仙	少儿
巴塞罗那	电视剧
巴拉拉小魔仙	少儿
巴斯鲈钓	体育
巴黎秋冬	生活
帮帮龙出动	少儿
幸福的味道	健康
幸福纪录	科教
幸福账单	综艺
康定情歌	电视剧
廉政时空	生活
开讲啦	综艺
开门大吉	音乐
异于常人	纪实
张学良与	电视剧
弹无虚发	电影
微视频大赛	综艺
德国艺术	纪实
志明与春娇	电影
快乐戏园	戏曲
快乐老家	电影
怎样建造一个星球	纪实
急诊室故事	综艺
恐龙星球	纪实
情谜睡美人	电视剧
戏里戏外	综艺
成语故事	少儿
我们相爱吧	综艺
我想和你唱	综艺
我是旅行家	旅游
我是杜拉拉	电视剧
我是歌手	音乐
我是证人	电影
我有传家宝	科教
我的世界	体育
我的中国	综艺
我的动物救星	纪实
我要上春晚	综艺
战龙四驱	少儿
戛纳电影节	综艺
抗战胜利	综艺
挑战不可能	综艺
挑战九宫	综艺
搭档全纪录	综艺
摩尔庄园	少儿
摩托范儿	健康
政风热线	新闻
故事大王	综艺
数字飙榜	综艺
文化讲坛	科教
文明中华行	旅游
文明之旅	综艺
新华纵横	新闻
新大头儿子和小头爸爸	少儿
新概念	科教
新洛神	电视剧
旋风十一人	电视剧
早安山东	新闻
早间开心果	少儿
早间气象	生活
时代问答	综艺
时光旅的恋人	电影
明星同乐会	综艺
星光大道	综艺
星星的礼物	综艺
星球大战	综艺
星际宝贝神奇	电视剧
星际迷航	电影
春节联欢晚会	综艺
是真的吗	财经
晚间气象	生活
智勇双全	综艺
最佳拍档	综艺
最后一战	电视剧
最强大脑	综艺
最强天团	综艺
最终幻想	电影
最美是你	电视剧
有请老大	美食
本草中国	纪实
来吧冠军	综艺
来自星星的你	电视剧
杨门女将	电视剧
极速狂飙	纪实
极限挑战	综艺
极限运动	体育
柠檬初上	电视剧
梁山伯与	电视剧
梦想合伙人	综艺
梦想改造家	综艺
梨园春秋	戏曲
模王小咖秀	综艺
欢乐喜剧人	综艺
欢乐颂	电视剧
欢乐饭米粒儿	综艺
正义红师	少儿
正义联盟	少儿
武林外传	电视剧
武林风	综艺
武神赵子龙	电视剧
死亡密码	电影
殊死七日	电视剧
每周质量报告	新闻
每日游报	新闻
水木学堂	少儿
江苏卫视	综艺
江苏新时	新闻
沉默的羔羊	电影
法律讲堂	法制
洛宝贝爱科学	少儿
活色生香	电视剧
海上钢琴师	电影
海峡艺术名家	科教
淘最报报	新闻
淘最新靓点	时尚
淮海战役	电影
深度国际	新闻
温暖在身边	生活
游戏大厅	体育
滚滚红尘	电视剧
滚蛋吧肿瘤君	电影
潜伏在黎明之前	电视剧
潜水艇巡航	纪实
澳大利亚	电影
濒危物种	纪实
火线三兄弟	电视剧
火锅英雄	电影
炉石传说	体育
烈焰奇侠	电影
焦点访谈	法制
熊出没	少儿
燃烧吧卡路里	综艺
爱上牛芳	综艺
爱人的谎言	电视剧
爱情保卫战	综艺
爱情公寓	电视剧
爱的礼物	电视剧
爱的追踪	电视剧
父亲的身份	电视剧
父老乡亲	电影
爸爸回来了	综艺
特别呈现	纪实
特别节目	综艺
特殊职业	纪实
狼牙英雄	电视剧
猎神冬日之战	电影
猪猪侠	少儿
猫和老鼠	少儿
环塔征途	体育
环球奇闻大搜索	纪实
瑞士女排精英	综艺
生命的故事	纪实
生活全接触	综艺
生活早参考	生活
生活时尚	生活
生活有点甜	电视剧
生活服务	生活
男人的全球购物	时尚
男女关系之密语	电影
男神女神	综艺
男过女人关	综艺
画坛巨匠	科教
疯狂动物城	电影
疯狂的丛林	综艺
百变机兽之洛洛历险记	少儿
百变猪猪侠	少儿
百变车妆	汽车
百姓故事	生活
百家讲坛	科教
百鸟朝凤	电影
直播生活	生活
真LIVE	音乐
真实故事	综艺
碟中谍	电影
神偷奶爸	电影
祥林嫂	电影
空中美术	科教
穿越时空	纪实
穿越火线	电视剧
笑傲江湖	综艺
笑林大会	综艺
笑逐言开	综艺
第88届奥斯卡颁奖礼	综艺
第五元素	电影
第六届北京	综艺
米奇妙妙屋	少儿
精品财经纪录	纪实
精彩1刻	综艺
精彩一刻	综艺
精英部队	电影
精选黄金档	电影
红岩本色	新闻
红楼梦	电视剧
红色	法制
纪录时间	生活
纪录电影	电影
纳尼亚传奇	电影
经典人文地理	科教
继承者们	电视剧
综艺盛典	综艺
绿色中国	生活
美丽中国	纪实
美丽俏佳人	时尚
美丽的草原我的家	电视剧
美味人生	美食
美国队长	电影
美术大家	科教
翻开这一页	少儿
老妈驾到	综艺
老巢新窝	综艺
聊斋新编	电视剧
职业骑牛赛	体育
致单身男女	电视剧
舞蹈世界	综艺
艺术人生	综艺
艺览天下	综艺
节目预告片	生活
花样姐姐	综艺
花漾梦工厂	综艺
茗天闪亮	电视剧
茶叶之路	纪实
荒野求生	综艺
荒野猎人	电影
荔枝大剧秀	综艺
蒙面歌王	综艺
蜜蜂少女	综艺
蝙蝠侠前传	电影
血战四平	电影
解决问题	科教
解放战争	纪实
解译新三	财经
记住乡愁	纪实
诉讼双雄	电视剧
说出你的故事	综艺
谁是大歌神	综艺
谁的青春不迷茫	电影
调查	新闻
贝克汉姆	电影
贝瓦儿歌	少儿
贝贝熊历险记	少儿
贵妃醉酒	戏曲
赛尔号之圣者逆袭	少儿
走近中国	纪实
走遍中国	纪实
走遍全世界阿涩	旅游
超级大	综艺
超级旅行团	旅游
超级美味	综艺
超级英雄	电影
超级视觉	纪实
超能陆战队	少儿
越女争锋	戏曲
车迷演播室	汽车
这里是新疆	电影
迪亚哥	少儿
透鲜滴星期天	综艺
遇见丝路	旅游
道德与法治	法制
道德观察	法制
遗失的金字塔	纪实
那些年我	音乐
那年青春我们正好	电视剧
鄂尔多斯风暴	电视剧
酷片酷映	少儿
酷车实验室	纪实
酷酷小吉	少儿
野性美洲	纪实
野生动物	电影
野蛮女友	电视剧
铠甲勇士	电影
锋狂实验室	科教
锦绣梨园	戏曲
镖行天下前传	电影
闪亮茗天	电视剧
阳光大道	农业
隋唐英雄	电视剧
霍比特人	电影
青丘狐传说	电视剧
青岛往事	电视剧
青年说	综艺
青春戏苑	戏曲
青春朋友圈	电视剧
非常	综艺
非常完美	综艺
非常星发布	综艺
非诚勿扰	综艺
韩潮旋风	音乐
音乐传奇	音乐
风雨下钟山	电影
食来运转	美食
魅力津巴布韦	纪实
魔法造型	生活
麻辣芳邻	电视剧
黄石公园	纪实
黑夜传说	电影
黑手党风云录	纪实
齐鲁先锋	新闻
龙纹身的女孩	电影