300英雄	体育
GetItBeauty	时尚
RunningMan	综艺
一声所爱大地飞歌	音乐
一日一字	科教
一鸣惊人	戏曲
东北解放战争全纪录	电视剧
中华情	综艺
中国之星	综艺
中国成语大会	科教
中国诗词大会	综艺
中国谜语大会	生活
乐比悠悠	少儿
乐游人生	综艺
书画人生	科教
今童王世界	少儿
优秀儿童剧	少儿
你最想知道的科学	纪实
信号	电视剧
全球财经	财经
养护宝典	汽车
养生堂	科教
养生汇	健康
决战背后的决战	纪实
创富	财经
厨王争霸	综艺
古老的世界	电视剧
另一片天空	旅游
名厨出走记	生活
周末特供	时尚
唐宋八大家	纪实
地平线系列	纪实
大爱东方	综艺
大魔术师	综艺
天天健康	健康
太阳的后裔	电视剧
奉化94天	电视剧
孔府档案	纪实
孙子兵法	科教
宝贝乐园	少儿
寰宇视野	科教
小狐狸发明记	少儿
岁月丹青	纪实
巴斯鲈钓	体育
开讲啦	综艺
异于常人	纪实
当卢浮宫遇见紫禁城	纪实
微视频大赛	综艺
快乐的旅行	旅游
成语故事	少儿
我是旅行家	旅游
我的世界	体育
我的动物救星	纪实
我的导游是明星	旅游
战龙四驱	少儿
数字飙榜	综艺
文化讲坛	科教
文明之旅	综艺
新华纵横	新闻
早安山东	新闻
早间开心果	少儿
明星同乐会	综艺
是真的吗	财经
最强天团	综艺
有请老大	美食
杨门女将	电视剧
极速狂飙	纪实
欢乐饭米粒儿	综艺
每日游报	新闻
水木学堂	少儿
洛宝贝爱科学	少儿
深度国际	新闻
游戏大厅	体育
濒危物种	纪实
焦点访谈	法制
熊出没	综艺
燃烧吧卡路里	综艺
爱上牛芳	综艺
爱情保卫战	综艺
特别呈现	纪实
特别节目	综艺
猪猪侠	少儿
猫和老鼠	少儿
环球奇闻大搜索	纪实
男人的全球购物	时尚
疯狂的丛林	综艺
百变车妆	汽车
真实故事	综艺
米奇妙妙屋	少儿
精品财经纪录	纪实
精选黄金档	电影
纪录时间	生活
纪录电影	电影
翻开这一页	少儿
职业骑牛赛	体育
自由脚步	生活
茶叶之路	纪实
荔枝大剧秀	综艺
解放战争	纪实
说出你的故事	综艺
调查	新闻
贝贝熊历险记	少儿
赛尔号之圣者逆袭	少儿
超级旅行团	旅游
车迷演播室	汽车
迪亚哥	少儿
道德与法治	法制
野外露营	纪实
野性美洲	纪实
锋狂实验室	科教
锦绣梨园	戏曲
青年说	综艺
青春戏苑	戏曲
非常星发布	综艺
魅力都市	旅游
黄石公园	纪实
黑手党风云录	纪实
齐鲁先锋	新闻